##### 
# p # 
# o # 
# o # 
# o # 
### ##
 #+ +#
 #   #
 # + #
 #####