   #####   
  #p +o #  
 ## ### ## 
#   ###   #
# ##   ## #
#    #    #
 ######### 