##### 
# o+##
# o#+#
#  w #
## p #
 #####