#####      
# p #      
##### #####
      # o+#
      #####