 ######
#O   o#
#  p  #
#+    #
###### 