##### 
# o+##
# o#+#
#    #
## p #
 #####