#####
#po+##
# o#+#
#    #
##   #
 #####