 ###### 
# p#+  #
#  #   #
#   o  #
# o + ##
######  