########
# p##   
#  ##  #
#      #
# o +  #
########