 ######
#O   o#
#  p  #
#+    #
#     #
###### 