######
#P O+#
#o o##
#   ##
######